79,79,79,79,79,79,79,79,79,79,79,79,79,79,79,79,79,79,79,79,79,79,79,79,79,79,79,79,79,79,79,79,79,79,79,79,79,79,79,79,79,79,79,79,79,79,79,79,79,79,79,79,79,79,79,79,79,79,79,79,79,79,79,79,79,79
79,79,79,79,79,79,79,79,79,79,79,79,79,79,79,79,79,79,79,79,79,79,79,79,79,79,79,79,79,79,79,79,79,79,79,79,79,79,79,79,79,79,79,79,79,79,79,79,79,79,79,79,79,79,79,79,79,79,79,79,79,79,79,79,79,79
79,79,79,79,79,79,79,79,79,79,79,79,79,79,79,79,79,79,79,79,79,79,79,79,79,79,79,79,79,79,79,79,79,79,79,79,79,79,79,79,79,79,79,79,79,79,79,79,79,79,79,79,79,79,79,79,79,79,79,79,79,79,79,79,79,79
79,79,79,79,79,79,79,79,79,79,79,79,79,79,79,79,79,79,79,79,79,79,79,79,79,79,79,79,79,79,79,79,79,79,79,79,79,79,79,79,79,79,79,79,79,79,79,79,79,79,79,79,79,79,79,79,79,79,79,79,79,79,79,79,79,79
79,79,79,79,79,79,79,79,79,0,1,1,1,1,1,1,1,1,1,1,1,1,1,1,1,1,1,1,1,1,1,1,1,1,1,1,1,1,1,1,1,1,1,1,1,1,1,1,1,1,1,1,1,1,1,1,5,79,79,79,79,79,79,79,79,79
79,79,79,79,79,79,79,79,79,10,79,79,79,79,79,79,79,79,79,79,79,79,79,79,79,79,79,79,79,79,79,79,78,78,79,79,79,79,79,79,79,79,79,79,79,79,79,79,79,79,79,79,79,79,79,79,15,79,79,79,79,79,79,79,79,79
79,79,79,79,79,79,79,79,79,10,79,79,79,79,79,79,79,79,79,79,79,79,79,79,79,79,79,79,79,79,79,79,78,78,79,79,79,79,79,79,79,79,79,79,79,79,79,79,79,79,79,79,79,79,79,79,15,79,79,79,79,79,79,79,79,79
79,79,79,79,79,79,79,79,79,10,79,79,79,79,79,79,79,79,79,79,79,79,79,79,79,79,79,79,79,79,79,79,78,78,79,79,79,79,79,79,79,79,79,79,79,79,79,79,79,79,79,79,79,79,79,79,15,79,79,79,79,79,79,79,79,79
79,79,79,79,79,79,79,79,79,10,79,79,79,79,79,79,79,79,79,79,79,79,79,79,79,79,79,79,79,79,79,79,78,78,79,79,79,79,79,79,79,79,79,79,79,79,79,79,79,79,79,79,79,79,79,79,15,79,79,79,79,79,79,79,79,79
79,79,79,79,79,79,79,79,79,10,79,79,79,79,79,79,79,79,79,79,79,79,79,79,79,79,79,79,79,79,79,79,78,78,79,79,79,79,79,79,79,79,79,79,79,79,79,79,79,79,79,79,79,79,79,79,15,79,79,79,79,79,79,79,79,79
79,79,79,79,79,79,79,79,79,10,79,79,79,79,79,79,79,79,79,79,79,79,79,79,79,79,79,79,79,79,79,79,78,78,79,79,79,79,79,79,79,79,79,79,79,79,79,79,79,79,79,79,79,79,79,79,15,79,79,79,79,79,79,79,79,79
79,79,79,79,79,79,79,79,79,10,79,79,79,79,79,79,79,79,79,79,79,79,79,79,79,79,79,79,79,79,79,78,78,78,79,79,79,79,79,79,79,79,79,79,79,79,79,79,79,79,79,79,79,79,79,79,15,79,79,79,79,79,79,79,79,79
79,79,79,79,79,79,79,79,79,10,79,79,79,79,79,79,79,79,79,79,79,79,79,79,79,79,79,79,79,79,79,78,78,78,79,79,79,79,79,79,79,79,79,79,79,79,79,79,79,79,79,79,79,79,79,79,15,79,79,79,79,79,79,79,79,79
79,79,79,79,79,79,79,79,79,10,79,79,79,79,79,79,79,79,79,79,79,79,79,79,79,79,79,79,79,79,79,78,78,79,79,79,79,79,79,79,79,79,79,79,79,79,79,79,79,79,79,79,79,79,79,79,15,79,79,79,79,79,79,79,79,79
79,79,79,79,79,79,79,79,79,10,79,79,79,79,79,79,79,79,79,79,79,79,79,79,79,79,79,79,79,79,79,78,78,79,79,79,79,79,79,79,79,79,79,79,79,79,79,79,79,79,79,79,79,79,79,79,15,79,79,79,79,79,79,79,79,79
79,79,79,79,79,79,79,79,79,10,79,79,79,79,79,79,79,79,79,79,79,79,79,79,79,79,79,79,79,79,79,78,78,79,79,79,79,79,79,79,79,79,79,79,79,79,79,79,79,79,79,79,79,79,79,79,15,79,79,79,79,79,79,79,79,79
79,79,79,79,79,79,79,79,79,10,79,79,79,79,79,79,79,79,79,79,79,79,79,79,79,79,79,79,79,79,79,78,78,79,79,79,79,79,79,79,79,79,79,79,79,79,79,79,79,79,79,79,79,79,79,79,15,79,79,79,79,79,79,79,79,79
79,79,79,79,79,79,79,79,79,10,79,79,79,79,79,79,79,79,79,79,79,79,79,79,79,79,79,79,79,79,79,78,78,79,79,79,79,79,79,79,79,79,79,79,79,79,79,79,79,79,79,79,79,79,79,79,15,79,79,79,79,79,79,79,79,79
79,79,79,79,79,79,79,79,79,10,79,79,79,79,79,79,79,79,79,79,79,79,79,79,79,79,79,79,79,79,79,78,78,79,79,79,79,79,79,79,79,79,79,79,79,79,79,79,79,79,79,79,79,79,79,79,15,79,79,79,79,79,79,79,79,79
79,79,79,79,79,79,79,79,79,40,41,41,41,41,41,41,41,41,41,5,79,79,79,79,79,79,79,79,79,79,79,78,78,79,79,79,79,79,79,79,79,79,79,79,79,0,44,44,44,44,44,44,44,44,44,44,45,79,79,79,79,79,79,79,79,79
79,79,79,79,79,79,79,79,79,79,79,79,79,79,79,79,79,79,79,15,79,79,79,79,79,79,79,79,79,79,79,78,78,79,79,79,79,79,79,79,79,79,79,79,79,10,79,79,79,79,79,79,79,79,79,79,79,79,79,79,79,79,79,79,79,79
79,79,79,79,79,79,79,79,79,79,79,79,79,79,79,79,79,79,79,15,79,79,79,79,79,79,79,79,79,79,79,78,78,79,79,79,79,79,79,79,79,79,79,79,79,10,79,79,79,79,79,79,79,79,79,79,79,79,79,79,79,79,79,79,79,79
79,79,79,79,79,79,79,79,79,79,79,79,79,79,79,79,79,79,79,15,79,79,79,79,79,79,79,79,79,79,79,78,78,79,79,79,79,79,79,79,79,79,79,79,79,10,79,79,79,79,79,79,79,79,79,79,79,79,79,79,79,79,79,79,79,79
79,79,79,79,79,79,79,79,79,0,44,44,44,44,44,44,44,44,44,45,79,79,79,79,79,79,79,79,79,79,79,78,78,79,79,79,79,79,79,79,79,79,79,79,79,40,41,41,41,41,41,41,41,41,41,41,5,79,79,79,79,79,79,79,79,79
79,79,79,79,79,79,79,79,79,10,79,79,79,79,79,79,79,79,79,79,79,79,79,79,79,79,79,79,79,79,79,78,78,79,79,79,79,79,79,79,79,79,79,79,79,79,79,79,79,79,79,79,79,79,79,79,35,79,79,79,79,79,79,79,79,79
79,79,79,79,79,79,79,79,79,10,79,79,79,79,79,79,79,79,79,79,79,79,79,79,79,79,79,79,79,79,79,78,78,79,79,79,79,79,79,79,79,79,79,79,79,79,79,79,79,79,79,79,79,79,79,79,15,79,79,79,79,79,79,79,79,79
79,79,79,79,79,79,79,79,79,10,79,79,79,79,79,79,79,79,79,79,79,79,79,79,79,79,79,79,79,79,79,78,78,79,79,79,79,79,79,79,79,79,79,79,79,79,79,79,79,79,79,79,79,79,79,79,15,79,79,79,79,79,79,79,79,79
79,79,79,79,79,79,79,79,79,10,79,79,79,79,79,79,79,79,79,79,79,79,79,79,79,79,79,79,79,79,79,78,78,79,79,79,79,79,79,79,79,79,79,79,79,79,79,79,79,79,79,79,79,79,79,79,15,79,79,79,79,79,79,79,79,79
79,79,79,79,79,79,79,79,79,10,79,79,79,78,78,78,78,78,78,78,78,78,78,78,78,78,78,78,78,78,78,78,78,78,78,78,78,78,78,78,78,79,79,79,79,79,79,79,79,79,79,79,79,79,79,79,15,79,79,79,79,79,79,79,79,79
79,79,79,79,79,79,79,79,79,10,79,79,79,78,78,78,78,78,78,78,78,78,78,78,78,78,78,78,78,78,78,78,78,78,78,78,78,78,78,78,78,78,78,78,79,79,79,79,79,79,79,79,79,79,79,79,15,79,79,79,79,79,79,79,79,79
79,79,79,79,79,79,79,79,79,10,79,79,79,79,79,79,79,79,79,79,79,79,79,79,79,79,79,79,79,79,79,79,79,79,79,79,79,79,79,78,78,78,78,78,78,79,79,79,79,79,79,79,79,79,79,78,15,79,79,79,79,79,79,79,79,79
79,79,79,79,79,79,79,79,79,10,79,79,79,79,79,79,79,79,79,79,79,79,79,79,79,79,79,79,79,79,79,79,79,79,79,79,79,79,79,79,79,78,78,78,78,78,79,79,79,79,79,79,79,79,79,79,15,79,79,79,79,79,79,79,79,79
79,79,79,79,79,79,79,79,79,10,79,79,79,79,79,79,79,79,79,79,79,79,79,79,79,79,79,79,79,79,79,79,79,79,79,79,79,79,79,79,79,79,78,78,78,78,78,79,79,79,79,79,79,79,79,79,15,79,79,79,79,79,79,79,79,79
79,79,79,79,79,79,79,79,79,10,79,79,79,79,79,79,79,79,79,79,79,79,79,79,79,79,79,79,79,79,79,79,79,79,79,79,79,79,79,79,79,79,79,78,78,78,78,78,79,79,79,79,79,79,79,79,15,79,79,79,79,79,79,79,79,79
79,79,79,79,79,79,79,79,79,10,79,79,79,79,79,79,79,79,79,79,79,79,79,79,79,79,79,79,79,79,79,79,79,79,79,79,79,79,79,79,79,79,79,79,78,78,78,78,79,79,79,79,79,79,79,79,15,79,79,79,79,79,79,79,79,79
79,79,79,79,79,79,79,79,79,10,79,79,79,79,79,79,79,79,79,79,79,79,79,79,79,79,79,79,79,79,79,79,79,79,79,79,79,79,79,79,79,79,79,79,79,79,78,78,79,79,79,79,79,79,79,79,15,79,79,79,79,79,79,79,79,79
79,79,79,79,79,79,79,79,79,10,79,79,79,79,79,79,79,79,79,79,79,79,79,79,79,79,79,79,79,79,79,79,79,79,79,79,79,79,79,79,79,79,79,79,79,79,78,78,79,79,79,79,79,79,79,79,15,79,79,79,79,79,79,79,79,79
79,79,79,79,79,79,79,79,79,10,79,79,79,79,79,79,79,79,79,79,79,79,79,79,79,79,79,79,79,79,79,79,79,79,79,79,79,79,79,79,79,79,79,79,79,79,78,78,79,79,79,79,79,79,79,79,15,79,79,79,79,79,79,79,79,79
79,79,79,79,79,79,79,79,79,10,79,79,79,79,79,79,79,79,79,79,79,79,79,79,79,79,79,79,79,79,79,79,79,79,79,79,79,79,79,79,79,79,79,79,79,79,78,78,79,79,79,79,79,79,79,79,35,79,79,79,79,79,79,79,79,79
79,79,79,79,79,79,79,79,79,40,41,41,41,41,41,41,41,41,41,41,41,41,41,41,41,41,41,41,41,41,41,41,41,41,41,41,41,5,79,79,79,79,79,79,79,79,78,78,79,79,79,79,79,79,79,79,35,79,79,79,79,79,79,79,79,79
79,79,79,79,79,79,79,79,79,79,79,79,79,79,79,79,79,79,79,79,79,79,79,79,79,79,79,79,79,79,79,79,79,79,79,79,79,15,79,79,79,79,79,79,79,79,78,78,79,79,79,79,79,79,79,79,35,79,79,79,79,79,79,79,79,79
79,79,79,79,79,79,79,79,79,79,79,79,79,79,79,79,79,79,79,79,79,79,79,79,79,79,79,79,79,79,79,79,79,79,79,79,79,15,79,79,79,79,79,79,79,79,78,78,79,79,79,79,79,79,79,79,35,79,79,79,79,79,79,79,79,79
79,79,79,79,79,79,79,79,79,79,79,79,79,79,79,79,79,79,79,79,79,79,79,79,79,79,79,79,79,79,79,79,79,79,79,79,79,15,79,79,79,79,79,79,79,79,78,78,79,79,79,79,79,79,79,79,35,79,79,79,79,79,79,79,79,79
79,79,79,79,79,79,79,79,79,79,79,79,79,79,79,79,79,79,79,79,79,79,79,79,79,79,79,79,79,79,79,79,79,79,79,79,79,15,79,79,79,79,79,79,79,79,78,78,79,79,79,79,79,79,79,79,35,79,79,79,79,79,79,79,79,79
79,79,79,79,79,79,79,79,79,79,79,79,79,79,79,79,79,79,79,79,79,79,79,79,79,79,79,79,79,79,79,79,79,79,79,79,79,15,79,79,79,79,79,79,79,79,78,78,79,79,79,79,79,79,79,79,35,79,79,79,79,79,79,79,79,79
79,79,79,79,79,79,79,79,79,79,79,79,79,79,79,79,79,79,79,79,79,79,79,79,79,79,79,79,79,79,79,79,79,79,79,79,79,15,79,79,79,79,79,79,79,79,78,78,79,79,79,79,79,79,79,79,35,79,79,79,79,79,79,79,79,79
79,79,79,79,79,79,79,79,79,79,79,79,79,79,79,79,79,79,79,79,79,79,79,79,79,79,79,79,79,79,79,79,79,79,79,79,79,15,79,79,79,79,79,79,79,79,78,78,79,79,79,79,79,79,79,79,35,79,79,79,79,79,79,79,79,79
79,79,79,79,79,79,79,79,79,79,79,79,79,79,79,79,79,79,79,79,79,79,79,79,79,79,79,79,79,79,79,79,79,79,79,79,79,15,79,79,79,79,79,79,79,79,78,78,79,79,79,79,79,79,79,79,35,79,79,79,79,79,79,79,79,79
79,79,79,79,79,79,79,79,79,79,79,79,79,79,79,79,79,79,79,79,79,79,79,79,79,79,79,79,79,79,79,79,79,79,79,79,79,15,79,79,79,79,79,79,79,79,78,78,79,79,79,79,79,79,79,79,35,79,79,79,79,79,79,79,79,79
79,79,79,79,79,79,79,79,79,79,79,79,79,79,79,79,79,79,79,79,79,79,79,79,79,79,79,79,79,79,79,79,79,79,79,79,79,15,79,79,79,79,79,79,79,79,78,78,79,79,79,79,79,79,79,79,35,79,79,79,79,79,79,79,79,79
79,79,79,79,79,79,79,79,79,79,79,79,79,79,79,79,79,79,79,79,79,79,79,79,79,79,79,79,79,79,79,79,79,79,79,79,79,15,79,79,79,79,79,79,79,79,78,78,79,79,79,79,79,79,79,79,35,79,79,79,79,79,79,79,79,79
79,79,79,79,79,79,79,79,79,79,79,79,79,79,79,79,79,79,79,79,79,79,79,79,79,79,79,79,79,79,79,79,79,79,79,79,79,15,79,79,79,79,79,79,79,79,78,78,79,79,79,79,79,79,79,79,35,79,79,79,79,79,79,79,79,79
79,79,79,79,79,79,79,79,79,79,79,79,79,79,79,79,79,79,79,79,79,79,79,79,79,79,79,79,79,79,79,79,79,79,79,79,79,41,44,44,44,44,44,44,44,44,44,44,44,44,44,44,44,41,41,41,45,79,79,79,79,79,79,79,79,79
79,79,79,79,79,79,79,79,79,79,79,79,79,79,79,79,79,79,79,79,79,79,79,79,79,79,79,79,79,79,79,79,79,79,79,79,79,79,79,79,79,79,79,79,79,79,79,79,79,79,79,79,79,79,79,79,79,79,79,79,79,79,79,79,79,79
79,79,79,79,79,79,79,79,79,79,79,79,79,79,79,79,79,79,79,79,79,79,79,79,79,79,79,79,79,79,79,79,79,79,79,79,79,79,79,79,79,79,79,79,79,79,79,79,79,79,79,79,79,79,79,79,79,79,79,79,79,79,79,79,79,79
79,79,79,79,79,79,79,79,79,79,79,79,79,79,79,79,79,79,79,79,79,79,79,79,79,79,79,79,79,79,79,79,79,79,79,79,79,79,79,79,79,79,79,79,79,79,79,79,79,79,79,79,79,79,79,79,79,79,79,79,79,79,79,79,79,79
79,79,79,79,79,79,79,79,79,79,79,79,79,79,79,79,79,79,79,79,79,79,79,79,79,79,79,79,79,79,79,79,79,79,79,79,79,79,79,79,79,79,79,79,79,79,79,79,79,79,79,79,79,79,79,79,79,79,79,79,79,79,79,79,79,79
79,79,79,79,79,79,79,79,79,79,79,79,79,79,79,79,79,79,79,79,79,79,79,79,79,79,79,79,79,79,79,79,79,79,79,79,79,79,79,79,79,79,79,79,79,79,79,79,79,79,79,79,79,79,79,79,79,79,79,79,79,79,79,79,79,79
79,79,79,79,79,79,79,79,79,79,79,79,79,79,79,79,79,79,79,79,79,79,79,79,79,79,79,79,79,79,79,79,79,79,79,79,79,79,79,79,79,79,79,79,79,79,79,79,79,79,79,79,79,79,79,79,79,79,79,79,79,79,79,79,79,79
79,79,79,79,79,79,79,79,79,79,79,79,79,79,79,79,79,79,79,79,79,79,79,79,79,79,79,79,79,79,79,79,79,79,79,79,79,79,79,79,79,79,79,79,79,79,79,79,79,79,79,79,79,79,79,79,79,79,79,79,79,79,79,79,79,79